XXXXXXXX
X1MOMOOX
XOOMOMOX
XOMOOOMX
XMOOOMOX
XOMOMOOX
XOOMOO2X
XXXXXXXX