XXXXXXXXXX
X1OOOMOOOX
XOOOOMOO2X
XOOOOMOOOX
XOOOMXMOOX
XOOMXOXMOX
XOMOOOOMOX
XMOOOOOOMX
XOOO3OOOOX
XXXXXXXXXX