XXXXXXXXXXXX
X1OOMOMOMOMX
XOOMOMOMOMOX
XOMOMOMOMOMX
XMOMOMOMOMOX
XOMOMOMOMOMX
XMOMOMOMOMOX
XOMOMOMOMOMX
XMOMOMOMOMOX
XOMOMOMOMOOX
XMOMOMOMOO2X
XXXXXXXXXXXX